32 25 
6 6 6 6 6 6 6 6 6 6 6 6 6 6 6 6 6 6 6 6 6 6 6 6 6 6 6 6 6 6 6 6 
6 6 6 6 6 6 6 6 6 6 6 6 6 6 6 6 6 6 6 6 6 6 6 6 6 6 6 6 6 6 6 6 
6 6 6 6 6 6 6 6 6 6 6 6 6 6 6 6 6 6 6 6 6 6 6 6 6 6 6 6 6 6 6 6 
6 6 6 6 6 6 6 6 6 6 6 6 6 6 6 6 6 6 6 6 6 6 6 6 6 6 6 6 6 6 6 6 
6 6 6 6 6 6 6 6 6 6 6 6 6 6 6 6 6 6 6 6 6 6 6 6 6 6 6 6 6 6 6 6 
6 6 6 6 6 6 6 6 6 6 6 6 6 6 6 6 6 6 6 6 6 6 6 6 6 6 6 6 6 6 6 6 
6 6 6 6 6 7 7 7 2 7 7 7 7 2 7 7 7 7 7 7 7 7 7 7 6 6 6 6 6 6 6 6 
6 6 6 6 6 7 7 7 2 7 7 7 7 2 7 7 7 7 7 7 7 7 7 7 6 6 6 6 6 6 6 6 
6 6 6 6 6 7 7 7 2 7 7 7 7 2 7 7 7 7 7 7 7 7 7 7 6 6 6 6 6 6 6 6 
6 6 6 6 6 7 7 7 2 7 7 7 7 2 7 7 2 2 2 2 2 7 7 7 6 6 6 6 6 6 6 6 
6 6 6 6 6 7 7 7 2 7 7 2 2 2 7 7 7 7 7 7 7 7 7 7 6 6 6 6 6 6 6 6 
6 6 6 6 6 7 7 7 7 7 7 7 7 7 7 7 7 7 7 7 2 7 7 7 6 6 6 6 6 6 6 6 
6 6 6 6 6 7 7 7 7 7 7 7 7 7 7 7 7 7 7 7 2 7 7 7 6 6 6 6 6 6 6 6 
6 6 6 6 6 7 7 7 7 7 7 7 7 7 7 7 7 7 7 7 2 7 7 7 6 6 6 6 6 6 6 6 
6 6 6 6 6 7 7 7 2 2 2 2 2 7 7 7 2 2 2 2 2 7 7 7 6 6 6 6 6 6 6 6 
6 6 6 6 6 7 7 7 7 7 7 7 2 7 7 7 2 7 7 7 7 7 7 7 6 6 6 6 6 6 6 6 
6 6 6 6 6 7 7 7 7 7 7 7 2 7 7 7 2 7 7 7 7 7 7 7 6 6 6 6 6 6 6 6 
6 6 6 6 6 7 7 7 7 7 7 7 2 7 7 7 2 7 7 7 7 7 7 7 6 6 6 6 6 6 6 6 
6 6 6 6 6 7 7 7 7 7 7 7 2 7 7 7 2 7 7 7 7 7 7 7 6 6 6 6 6 6 6 6 
6 6 6 6 6 6 6 6 6 6 6 6 6 6 6 6 6 6 6 6 6 6 6 6 6 6 6 6 6 6 6 6 
6 6 6 6 6 6 6 6 6 6 6 6 6 6 6 6 6 6 6 6 6 6 6 6 6 6 6 6 6 6 6 6 
6 6 6 6 6 6 6 6 6 6 6 6 6 6 6 6 6 6 6 6 6 6 6 6 6 6 6 6 6 6 6 6 
6 6 6 6 6 6 6 6 6 6 6 6 6 6 6 6 6 6 6 6 6 6 6 6 6 6 6 6 6 6 6 6 
6 6 6 6 6 6 6 6 6 6 6 6 6 6 6 6 6 6 6 6 6 6 6 6 6 6 6 6 6 6 6 6 
6 6 6 6 6 6 6 6 6 6 6 6 6 6 6 6 6 6 6 6 6 6 6 6 6 6 6 6 6 6 6 6 
house2.level